00 00 00 00 00 00 00 00 
00 00 00 00 00 00 00 00 
00 00 00 00 00 00 00 00 
00 00 00 00 00 00 00 00 
00 00 00 00 00 00 00 00 
00 00 00 00 00 00 00 00 
00 00 00 00 00 00 00 00 
d9 23 40 00 00 00 00 00 
72 22 40 00 00 00 00 00 
9d 22 40 00 00 00 00 00 
48 00 00 00 00 00 00 00 
64 23 40 00 00 00 00 00 
79 23 40 00 00 00 00 00 
04 23 40 00 00 00 00 00 
b6 22 40 00 00 00 00 00 
72 22 40 00 00 00 00 00 
8f 20 40 00 00 00 00 00 
33 30 63 64 31 65 65 34 
00 